渋谷凛	cool
道明寺歌鈴	cute
村上巴	passion
佐々木千枝	cool
遊佐こずえ	cute
姫川友紀	passion
白坂小梅	cool
藤本里奈	cute
日野茜	passion
佐城雪美	cool
乙倉悠貴	cute
城ヶ崎莉嘉	passion
速水奏	cool
関裕美	cute
松永涼	cool
片桐早苗	passion
三船美優	cool
五十嵐響子	cute
喜多見柚	passion
椎名法子	cute
相葉夕美	passion
二宮飛鳥	cool
中野有香	cute
八神マキノ	cool
赤城みりあ	passion
小早川紗枝	cute
依田芳乃	passion
安部菜々	cute
塩見周子	cool
大槻唯	passion
荒木比奈	cool
水本ゆかり	cute
龍崎薫	passion
宮本フレデリカ	cute
神谷奈緒	cool
森久保乃々	cool
佐藤心	passion
櫻井桃華	cute
高森藍子	passion
北条加蓮	cool
三村かな子	cute
藤原肇	cool
浜口あやめ	passion
佐久間まゆ	cute
星輝子	passion
輿水幸子	cute
高垣楓	cool
城ヶ崎美嘉	passion
アナスタシア	cool
小日向美穂	cute
堀裕子	passion
一ノ瀬志希	cute
鷺沢文香	cool
十時愛梨	passion
上条春菜	cool
早坂美玲	cute
新田美波	cool
諸星きらり	passion
双葉杏	cute
本田未央	passion
島村卯月	cute
緒方智絵里	cute
及川雫	passion
前川みく	cute
神崎蘭子	cool
橘ありす	cool
木村夏樹	passion
喜多日菜子	passion
向井拓海	passion
川島瑞樹	cool
市原仁奈	passion
多田李衣菜	cool
